1111111111111111111111111111
1P00C000000X00000X0000000001
101000X00C0000C00000C0000001
1010111111111111011111011111
101010000000000001X0C1010001
10001011111010010110110000E1
1101101X0C101CC1011011010001
1000101101101111000000011111
1CX01000000000000000000CX001
1111111111111111111111111111
