111111111
100X00001
1P000C0E1
111111111

