111111111
100X00001
1P0S0C0E1
111111111
